1111111111111111111111
1000000000000000000001
1000001111100000000001
1000010000010000000001
100P01000001000C000001
1000010000010000000001
1000010000010111000001
1000010000011000100001
1000010011100000100001
1001111100000001000001
1010000111111110000001
1010000100000010000001
1001111000111111000001
1000010001000000100001
1000010010000000010001
1001110010000000010001
1010010001000000010001
1010010001100001100001
1010010000011110100001
1010010000000000100001
1010010000000000100001
1010010000000000100001
1010010000000000100001
1010010000000000100001
1001110000000000100001
1000010000110000100001
1000010001001000100001
10000100010010001000E1
1000001110000111000001
1000000000000000000001
1111111111111111111111